Archaea::Assyrian:
CaptainAwesome::Soviet:
ForgetDeny:::
Grendel::Syrian:
IllvilJa::Swedish:
Joris::Mongol:
Kes_Of_Kobo:::
Kryon::Turkish:
Leo::Tibetan:
Lord_P::Palatinate:
MalibuJack::Amazigh:
Marduk::Chinese:
MbawsaRitchie::Palestinian:
Modeemirotta::Holy Roman:
Ramses::Egyptian:
Richard_lynx::British:
Rommel::Swiss:
Shogun::Macedonian:
Temmikael::Viking:
Trodan:::
Vendicar:::
Xercise::Iranian:
akfaew::Nimiipuu:
bamskamp::Raramuri:
cgalik::Slovakian:
chomwitt::Hellenic:
chuck::Quebecois:
det0r::Maori:
edrim::Pashtun:
el_perdedor::Cornish:
elpollodiablo::Austrian:
elrik::Polynesian:
fepf::Saxon:
fox::Siberian:
gayashiva:::
ifaesfu::Spanish:
jhh::Japanese:
johnhx::English:
jumangee::Hacker:
kingofnerds::Vampire:
kull::Portuguese:
kyrilus::Breton:
maho:::
matthewbauer::Carthaginian:
meton::Teutonic:
mmm2::Bosnian-Herzegovinian:
monamipierrot::Knights Templar:
mrsynical::Etruscan:
mwm:::
nah::Chola:
naldarn:::
o01eg::Barbarian:
ollikka:::
pipo::Norman:
qamil23::Tatar:
rsnk:::
slicer::Norwegian:
soon::Armenian:
troxalias::Greek:
viznut::Mixtec:
wieder::East German:
sokrat::French:
Archont::Liechtensteiner:
StewartFip::Hawaiian:
tzaeru::Asturian:
dunderklumpen::Brazilian:
Dimitril::Sikh:
wuschel::Numidian:
